100;21;
0000000000000000000440000004040404040404000000004040404040000000000040404040400000040404000000000001
0000000000000000003333000333333333333333330003333333333333333300033333333333333000333333333333333330
0000000000000000000000000000000000000000000000000000000000000000000000000000000000000000000000000000
0000000000000000000000000000000000000000000000000000000000000000000000000000000000000000000000000000
0000000000000000000000000000000000000000000000000000000000000000000000000000000000000000000000000000
0000000000000000000000000000000000000000000000000000000000000000000000000000000000000000000000000000
0000000000000000000000000000000000000000000000000000000000000000000000000000000000000000000000000000
0000000000000000000000000000000000000000000000000000000000000000000000000000000000000000000000000000
0000000000000000000000000000000000000000000000000000000000000000000000000000000000000000000000000000
0000000000000000000000000000000000000000000000000000000000000000000000000000000000000000000000000000
0000000000000000000000000000000000000000000000000000000000000000000000000000000000000000000000000000
0000000000000000000000000000000000000000000000000000000000000000000000000000000000000000000000000000
0000000000000000000000000000000000000000000000000000000000000000000000000000000000000000000000000000
0000000000000000000000000000000300000000030000000003000000000000300000000000300000000000030000000000
0000000000000000000000000000003330000000333000000033300000000003330000000003330000000000030000000000
0000000000000000000000000000333333333333333333333333333333333333333333333333333333333333330000000000
0000000000000000000000000003000000000000000000000000000000000000000000000000000000000000003000000000
0000000000000000000000000030000000000000000000000000000000000000000000000000000000000000000300000000
0000000005050505000000000300000000000000000000000000000000000000000000000000000000000000000030006000
0000000001111111111111111100000000000000000000000000000000000000000000000000000000000000000011111111
0000000001111111111111111100000000000000000000000000000000000000000000000000000000000000000011111111
