100;21;
0000000000000000000000000000000000000000000000000000000000000000000000000000000000000000000000000001
0000000000000000000000000000000000000000000000000000000000000000000000000000000000000000000000000000
0000000000000000000000000000000000000000000000003300333030003033003000000000000000000000000000000000
0000000000000000000000000000000000000000000000003030303030303030303000000000000000000000000000000000
0000000000000000000000000000000000000000000000003300333033033030033000000000000000000000000000000000
0000000000000000000000000000000003333333000000000000000000000000000000000000000000000000000000000000
0000000000000000000000000000000000000000000000000000000000000000000000000000000000000000000000000000
0000000000000000000000000003330000000000000033333333000000000000000000000000000000000000000000000000
0000000000000000000000000030000000000000000000000000000000000000000000000000000000000000000000000000
0000000000000000000000000300000000000000000000000000000000000000000000000000000000000000000000000000
0000000000000000000000000300000000000000000000000000000000000000000000000000000000000000000000000000
0000000000000000000000000300000000000000000000000000000000000000000000000000000000000000000000000000
0000000000000000000000003000000000000000000000000000000000000000000000000000000000000000000000000000
0000000000000000000000003000000000000000000000000000000000000000000000000000000000000000000000000000
0000000000000000000000003000000000000000000000000000000000000000000000000000000000000000000000000000
0000000000000000000000030000000000000000000000000000000000000000000000000000000000000000000000000000
0000000000000000000000300000000000000000000000000000000000000000000000000000000000000000000000000000
0000000000000000000003000000000000000000000000000000000000000000000000000000000000000003300000000000
5050050000000000000030000000000000000000000000000000000000000000000005050000000000000330000000000600
1111111111111111111100000000000000000000000000000000333333333333000033333000033333333000000000011111
1111111111111111111100000000000000000000000000000000000000000000000000000000000000000000000000011111
